OOOOOOOOOO
O O    O O
O . OOXO.O
O O O    O
OOOOOOOOUO